#summary Custom Stage Visual

{{{
    0   1   2   3   4   5   6   7   8   9  10  11  12  13  14  15  16  17
  +---+---+---+---+---+---+---+---+---+---+---+---+---+---+---+---+---+---+
0 |   |   |   |   |   |   |   |   |   |   |   |   |   |   |   |   |   |   |
  +---+---+---+---+---+---+---+---+---+---+---+---+---+---+---+---+---+---+
1 |   |   |   |   |   |   |   |   |   |   |   |   |   |   |   |   |   |   |
  +---+---+---+---+---+---+---+---+---+---+---+---+---+---+---+---+---+---+
2 |   |   |   |   |   |   |   |   |   |   |   |   |   |   |   |   |   |   |
  +---+---+---+---+---+---+---+---+---+---+---+---+---+---+---+---+---+---+
3 |   |   |   |   |   |   |   |   |   |   |   |   |   |   |   |   |   |   |
  +---+---+---+---+--SC---+---+---+---+---+---+---+---+---+---+---+---+---+
4 |   |   |   |   |   |   |   |   |   |   |   |   |   |   |   |   |   |   |
  +---+---+---+---+---+---+---+---+---+---+---+---+---+---+---+---+---+---+
5 |   |   |   |   |   |   |  MC   |   |   |   |   |   |   |   |   |   |   |
  +---+---+---+---+---+---+---+---+---+---+---+---+---+---+---+---+---+---+
6 |   |   |   |   |   |   |   |   |   |   |   |   |   |   |   |   |   |   |
  +---+---+---+---+---+---+---+---+--LC---+---+---+---+---+---+---+---+---+
7 |   |   |   |   |   |   |   |   |   | SB|   |   |   |   |   |   |   |   |
  +---+---+---+---+---+---+---+---+---+---+---+---+---+---+---+---+---+---+
8 |   |   |   |   |   |   |   |   |   |   |   |   |   |   |   |   |   |   |
  +---+---+---+---+---+---+---+---+---+---+---+---+---+---+---+---+---+---+
9 |   |   |   |   |   |   |   |   |   |   |   |   |   |   |   |   |   |   |
  +---+---+---+---+---+---+---+---+---+---+---+---+---+---+---+---+---+---+
10|   |   |   |   |   |   |   |   |   |   |   |   |   | MB|   |   |   |   |
  +---+---+---+---+---+---+---+---+---+---+---+---+---+---+---+---+---+---+
11|   |   |   |   |   |   |   |   |   |   |   |   |   |   |   |   |   |   |
  +---+---+---+---+---+---+---+---+---+---+---+---+---+---+---+---+---+---+
12|   |   |   |   |   |   |   |   |   |   |   |   |   |   |   |   |   |   |
  +---+---+---+---+---+---+---+---+---+---+---+---+---+---+---+---+---+---+
13|   |   |   |   |   |   |   |   |   |   |   |   |   |   |   |   |   | LB|
  +---+---+---+---+---+---+---+---+---+---+---+---+---+---+---+---+---+---+
14|   |   |   |   | <-- Last block (255)
  +---+---+---+---+

SB = Small Boundry
SC = Small Center
MB = Medium Boundry
MC = Medium Center
LB = Large Boundry
LC = Large Center
}}}